█████████████████████████████████████████
█♥         █              █        █    █
█              ████████   █  █████ █ ████
█  ████ █  █    █         █      █   █  █
█  █    █      ██  █  █   ██████ █████  █
█  █    █  █      ██♥♥██  █             █
█  █    █  █████          █  █ ♥ █  █   █
█  █    █  █      ██████  █  █████  █   █
█  █ ████  █                 █      █   █
█          █   █  █ █  ████  █   █  █   █
█          █   █             █          █
███    █████ ███  █↑█  █ █ █ █   █  █   █
█                 █♥█               █   █
█████████████████████████████████████████
